w,w,w,w,w,w,w,w,w,w,w,w,w,w,w,w,w,w,w,w
w,p,,,,,,,,,,X,,,,,,,,w,d
w,,,,,,,,,,,,,,,,,,,w
w,,,,,,,,,,,,,,,,,,,w
w,,,,bug,,,,,,,,,,,,,,,w
w,,,print,,,,,,,,,,,,,,,,w
w,,,,door,),,,,,,,,,,,,,,w
w,,,del,,,,,,,,,,,,,,,,w
w,,start,,,,,,,,,,,,,,,,,w
w,,,,,,,,,,,,,,,,,,,w
w,,,,,,,,,,,,,,,,,,,w
w,b,,,,,,,,,,,,,,,,,,w
w,w,w,w,w,w,w,w,w,w,w,w,w,w,w,w,w,w,w,w