w,w,w,w,w,w,w,w,w,w,w,w,w,w,w,w,w,w,w,w,d
w,p,vw,b,,,,,,,w,X,w,,,,,,,w,
w,,vw,,,,,,,,w,,w,,,,,,,w,
w,,vw,,,,,,,,,,,,,,,,,w,
w,,,,,,,,,,,,,,,,,,,w,
w,,start,,,,,,eb,,,,,,,,,,,w,
w,,,,,,,,,,,,,,,,,,,w,
w,,vw,,,vw,,,,,,,,,,,,,,w,
w,,vw,print,,vw,,,,,,,,,,,hw,hw,hw,w,
w,,vw,,,vw,,,,,,,,del,,door,,),,w,
w,,w,w,w,w,,,,,,,,,,,,,,w,
w,,,,,,,,,,,,,,,,,,,w,
w,w,w,w,w,w,w,w,w,w,w,w,w,w,w,w,w,w,w,w,