w,w,w,w,w,w,w,w,w,w,w,w,w,w,w,w,w,w,w,w,d
w,,,,,,,,,,,,,,,,,,,w,
w,,,,,,,,,,,,,,,,,,,w,
w,,,,,,,,,,,,,,,,,,,w,
w,,,,,,,,,,,,,,,,,,,w,
w,,,,,,,,,,,,,,,,,,,w,
w,,,,,,,,,,,,,,,,,,,w,
w,,,,,,,,,,,,,,,,,,,w,
w,,,,,,,,,,,,,,,,,,,w,
w,,,,,,,,,,,,,,,,,,,w,
w,,,,eb,,eb,,eb,,,,,p,,,,,,w,
w,,,,,,,,,,,,,,,,,,,w,
w,w,w,w,w,w,w,w,w,w,w,w,w,w,w,w,w,w,w,w,