w,w,w,w,w,w,w,w,w,w,w,w,w
w,,w,p,w,,,,w,,,,w
w,,w,,w,,,,,,,,w
w,,,c,,,,c,w,c,c,,w
w,,w,,w,,,,w,,w,,w
w,,w,w,w,,w,,w,,w,,w
w,,,,,,w,,,,w,,w
w,w,w,w,w,w,w,,w,,w,,w
w,,,,,,,,,,w,,w
w,w,w,w,w,w,w,w,w,w,w,w,w