w,w,w,w,w,w,w,w,w,w,w,w,w,w,w,w,w,w,w,w,d
w,p,,,del,bugs,,,,,w,X,w,,,,w,,,w,
w,,start,,,,,,,,w,,w,,bug1,,w,door,,w,
w,,,,,,,,,,,,,,,,w,,,w,
w,,,,,,,,,,,,,,,,w,,,w,
w,,,,,,,,,,,,,,,,,,,w,
w,,,,,,,,,,,,,,,,w,w,w,w,
w,,,,,,,,,,,,,bug1,,,,,,w,
w,,,,,,,,,,,,,,,,w,,,w,
w,,w,w,w,w,,w,w,w,w,w,,,,,w,,,w,
w,,w,,),,,,,,,w,,,,,w,print,,w,
w,b,w,,,,,,,,,w,,,,,w,,,w,
w,w,w,w,w,w,w,w,w,w,w,w,w,w,w,w,w,w,w,w,