w,w,w,w,w,w,w,w,w,w,w,w,w
w,,vw,p,vw,,,,w,,,,w
w,,vw,,vw,,,,,,,,w
w,,,c,,,,c,w,c,c,,w
w,,vw,,vw,,,,w,,vw,,w
w,,w,w,w,,w,,w,,vw,,w
w,,,,,,w,,,,vw,,w
w,hw,hw,hw,hw,hw,w,,w,,vw,,w
w,,,,,,,,,,vw,,w
w,w,w,w,w,w,w,w,w,w,w,w,w