w,w,w,w,w,w,w,w,w,w,w,w,w,w,w,w,w,w,w,w,d
w,bug1,,,,w,,,,,w,X,w,,,,,w,p,w,
w,,,,,w,,,,,w,,w,,,,,w,,w,
w,,,,,w,,,,,,,,,,,,w,,w,
w,,,print,,w,,,,,,,,,,,,,,w,
w,,,,,,,,,,,,,,,,,,,w,
w,,,,,,,,,,,door,,,,,,,,w,
w,,,,,,,,,,,,,,,,,,,w,
w,,,,,w,,,,,,,,,,,,,,w,
w,,,,,w,,,,,,,,,,,,w,w,w,
w,,,,,w,,,,,w,w,w,,,,,),,w,
w,bug1,,,,w,,bug1,,b,w,start,,,,,,,,w,
w,w,w,w,w,w,w,w,w,w,w,w,w,w,w,w,w,w,w,w,